###########
#      #  #
##### #####
#  #   #  #
#      #  #
#  #   #  #
#  ### #  #
#         #
#  #####  #
#         #
##########